Command,Finished,Error,Burst Time,Turnaround Time,Waiting Time,Response Time
./procesd 33 p4,No,Yes,100,403,303,303
./procesd 1 p8,No,Yes,100,811,711,711
./process 1 p1,Yes,No,1202,8031,6829,0
./process 2 p2,Yes,No,2103,14348,12245,101
./process 2 p6,Yes,No,2104,15253,13149,509
./process 2 p9,Yes,No,2104,16159,14055,817
./process 3 p7,Yes,No,3303,20670,17367,610
./process 4 p5,Yes,No,4203,23378,19175,408
./process 4 p10,Yes,No,4206,23683,19477,917
./process 6 p3,Yes,No,6007,25490,19483,202
